gfdgfd



SO ./textures/metal_dark2.xpm
NO ./textures/metal_dark2.xpm
WE ./textures/crate_metal5.xpm
EA ./textures/cr



F 60, 60, 60
C 35, 35, 35



        1111111111111111111111111
        1000000000110000000000011
        1011000001110000000000001
        1001000000000000000000001
111111111011000001110000111111111
100000000011000001110111111111111
11110111111111011100000010001
11110111111111011101010010001
11000000110101011100000010001
100000000000000011000000100P01
1000000000000000110101001000111
1100000111010101111101111000111
11110111 1110101 101111010001
11111111 1111111 111111111111