



SO ./textures/metal_dark2.xpm
NO ./textures/metal_dark2.xpm
WE ./textures/crate_metal5.xpm
EA ./textures/wall_white.xpm



F 60, 60, 60
C 35, 35, 35
F 60,250,4


        1111111111111111111111111
        1000000000110000000000011
        1110000011100000000000011
        1001000000000000000000001111
11111111011000011100001111111111
10000000001100000111011111111111111
1111011111111101110000001000111
11110111111111011101010010001
11000000110101011100000010001
100000000000000011000000100N01
1000000000000000110101001000111
110000011101010111101111000111
11110111 1110101 101111010001
11111111 1111111 111111111111