gfdgfd



SO ./textures/metal_dark2.xpm
NO ./textures/metal_dark2.xpm
WE ./textures/crate_metal5.xpm
EA ./textures/cr



F 60, 60, 60
C 35, 35, 35



1111111111111111111111111
1000000000110000000000001
1011000001110000000000001
100100000000000000000010111
11111111101100000111111111101
10000000001100000111011111
11110111111111011100000011101
11110111111111011101010011
11000000110101011100000011
10000000000000001100000011
1000000000000N001101010011
11000001110101011111011111101
11110111 1110101 101111010001
11111111 1111111 111111111111
