



SO ./textures/metal_dark2.xpm
NO ./textures/metal_dark2.xpm
WE ./textures/crate_metal5.xpm
EA ./textures/wall_white.xpm



F 60, 60, 60
C 35, 35, 35

    1    1111111111111111111111111
        1001000000110000000000001
        1011000001110000000000001
        10010000000000000000000011
11111111101100000111000000000000101                         
1000000000110000011101111111111101                
111101111111110111000000100011111                                                        
11110111111111011101010010001
1100000011010101110000S010001              
10000000010000001100000010001
1000000000000000110101001000111111
1100000111010101111101111000111                                    
11110111 1110101 101111010001
11111111 1111111 1111111111111   

