1111111111
1000011101
1100000011
110000N111
1111111111
